111111111111111111111
100000000000000000001
101011010111010101101
101011010000010101101
101011010101010101101
100000010101010000001
101111110101011111101
101000000000000000101
101011111110111110101
100000000000000000001
101111101101101111101
100000001101100000001
101110101101101011101
100000100000001000001
101110100000001011101
100000100000001000001
101111101101101111101
100000000000000000001
101111111101111111101
100000000000000000001
111111111111111111111
