111111111111111111111
110000000010000000011
116110111010111011611
110000000000000000011
110110101111101011011
110000100010001000011
111110111010111011111
111110100000001011111
111110101111101011111
111110001111100011111
111110101111101011111
111110100000001011111
111110101111101011111
110000000010000000011
116110111010111011611
110010000000000010011
111010101111101010111
110000100010001000011
110111111010111111011
110000000000000000011
111111111111111111111
